3,3,3,3,3,3,3,3,3,3,3,3,3,3,3,3,3,3,,,,,,,,0,0,0,0,0,0,0,0,2,2
3,3,3,3,3,3,3,3,3,3,3,3,3,3,3,3,3,3,,,,,,,,0,0,0,0,0,0,0,0,2,2
3,3,3,3,3,3,3,3,3,3,3,3,3,3,3,3,3,3,,,,,,,,0,0,0,0,0,0,0,0,2,2
3,0,0,0,0,0,0,0,0,0,0,0,0,0,0,0,0,3,,,,,,,,0,0,0,0,0,0,0,0,0,0
3,0,0,0,0,0,0,8,0,0,0,0,0,0,0,0,0,3,,,,,,,,0,0,0,0,0,0,0,0,0,0
3,0,0,0,0,0,0,6,0,9,0,0,0,0,0,0,0,3,,,,,,,,0,0,0,0,0,0,0,0,0,0
3,0,0,0,0,0,0,4,4,4,4,0,0,0,0,0,0,3,,,,,,,,0,0,0,0,0,0,0,0,0,0
3,0,0,0,0,0,0,4,0,0,4,0,0,0,0,0,0,3,,,,,,,,0,0,0,0,0,0,0,0,0,0
3,0,0,0,0,0,4,4,0,0,4,4,0,0,0,0,0,3,,,,,,,,0,0,0,0,0,0,0,0,0,0
3,0,0,0,4,4,4,4,4,4,4,4,4,4,0,0,0,3,,,,,,,,0,0,0,0,0,0,0,0,0,0
3,0,0,0,0,0,0,0,0,0,0,0,0,0,0,0,0,3,,,,,,,,0,0,0,0,0,0,0,0,0,0
3,5,0,0,0,0,0,0,0,0,0,0,0,0,0,0,5,3,,,,,,,,0,0,0,0,0,0,0,0,0,0
3,4,0,0,0,0,0,0,0,0,0,0,0,0,0,0,4,3,,,,,,,,0,0,0,0,0,0,0,0,0,0
3,0,0,0,0,0,0,0,0,0,0,0,0,0,5,0,0,3,,,,,,,,0,0,0,0,0,0,0,0,0,0
3,0,0,0,0,5,0,0,0,0,0,0,0,5,1,0,1,3,,,,,,,,0,0,4,0,0,4,0,0,0,0
3,0,0,0,0,1,5,0,0,0,0,0,5,1,1,1,1,3,,,,,,,,0,0,0,0,0,0,0,0,0,0
3,6,0,5,5,1,1,0,0,0,0,5,1,1,1,1,1,3,,,,,,,,0,0,0,0,0,0,0,0,0,0
3,4,4,4,4,4,4,0,0,0,0,4,4,4,4,4,4,3,,,,,,,,,,,,,,,,,
3,0,0,0,0,0,0,0,0,0,0,0,0,0,0,0,0,3,,,,,,,,,,,,,,,,,
3,0,0,0,0,0,0,0,0,5,0,0,0,0,0,0,0,3,,,,,,,,,,,,,,,,,
3,0,0,0,0,0,0,0,5,1,5,0,0,0,0,0,0,3,,,,,,,,,,,,,,,,,
3,0,0,0,0,0,0,0,1,1,1,0,0,0,0,0,0,3,,,,,,,,,,,,,,,,,
3,0,0,0,0,0,0,8,0,0,0,0,0,0,0,0,0,3,,,,,,,,,,,,,,,,,
3,0,0,0,0,0,0,5,0,5,0,5,0,0,0,0,0,3,,,,,,,,,,,,,,,,,
3,0,0,0,0,0,0,1,1,1,1,1,0,0,0,0,0,3,,,,,,,,,,,,,,,,,
3,0,0,0,0,0,0,0,0,0,0,0,0,0,0,0,0,3,,,,,,,,,,,,,,,,,
3,0,5,0,0,5,0,0,0,0,0,0,0,5,0,0,5,3,,,,,,,,,,,,,,,,,
3,0,1,0,0,1,0,0,0,0,0,0,0,1,0,0,1,3,,,,,,,,,,,,,,,,,
3,0,0,0,0,0,0,0,0,0,0,0,0,0,0,0,0,3,,,,,,,,,,,,,,,,,
3,0,0,5,5,0,7,0,0,0,0,0,0,0,5,5,0,3,,,,,,,,,,,,,,,,,
3,1,1,1,1,1,1,0,0,0,0,1,1,1,1,1,1,3,,,,,,,,,,,,,,,,,
3,0,0,0,0,0,0,0,0,0,0,0,0,0,0,0,0,3,,,,,,,,,,,,,,,,,
3,0,0,0,0,0,0,0,5,5,5,0,0,0,0,0,0,3,,,,,,,,,,,,,,,,,
2,2,2,2,2,2,2,2,2,2,2,2,2,2,2,2,2,2,,,,,,,,,,,,,,,,,
